00000000000000000000000000000000
01111111110000000000000000000000
01111111110000000000000000000000
01111111110000000000000000000000
01111111110000000000000000000000
01111111110000000000000000000000
01111111110000000000000000000000
00000000000000000000000000000000
00000000000000000000000000000000
00000000000000222000000000000000
00000000000000222000000000000000
00000000000000222000000000000000
00000000000000222000000000000000
00000000000000222000000000000000
00000000000000222000000000000000
00000000000000222000000000000000
00000000000000222000000000000000
00000000000000222000000000000000
00000000000000000000000000000000
00000000000000000000000000000000
0 0 4 15
1 0 15 7
1 0 12 13
2 0 20 8
2 0 25 19
3 0 7 3
0 1 27 4
1 1 30 7
1 1 14 13
2 1 7 7
2 1 22 10
3 1 17 18
