11111111111100000000000000000000
11111111110000000011000000000000
11111111111000000111100000000000
11111111111000000111100000000000
11111111111000000111100000000000
11111111000000000011000000000000
11111000000000000000000000000000
11110000001110000000000000000000
11100001111111100000000111222222
11000011111111000011111222222222
00000111111110011122222222222222
00000111111100112222222222220000
00000011111000122222222211111000
00000000000000122222211111111000
00000000000000222221111111111110
00000000000002222200011111100000
00000000000002222000000000000000
00000000000002222000000000000000
00000000000002220000000000000000
00000000000002220000000000000000
0 0 3 16
1 0 4 14
1 0 5 15
2 0 2 14
2 0 5 17
3 0 1 18
0 1 28 3
1 1 26 4
1 1 27 5
2 1 26 2
2 1 29 5
3 1 30 1
